11111111111111111111
1P00010M0C1000000001
100M0100011000000001
1C0000001E1000000001
10000000000000000001
10000000000000000001
10000000010000000001
10000000000000000001
11111111111111111111
