11111111111
1P00010M0C1
100M0100001
1C0000001E1
11111111111
