11111111111111111111
1000000M0000C000M001
1M000P000C00000000E1
10000M000000M00C0001
11111111111111111111
