1111111111111
10010000000011
10000100P0001
10C001E00000111
1111111111111
